...###
..##.#.####
.##..###.1#
##........#
#...@..#.0#
###..###..#
..#..#....#
.##.##.#.##
.#......##
.#.....##
.#######