...###
..##.#.####
.##..###.1#
##........#
#...@..#..#
###..###.0#
..#..#....#
.##.##.#.##
.#......##
.#.....##
.#######