##########
#......@.#
#........#
#..0.....#
#........#
#........#
#........#
#......1.#
#........#
##########