...###
..##.#.####
.##..###.1#
##........#
#...@..#..#
###..###..#
..#..#....#
.##.##.#.##
.#.0....##
.#.....##
.#######