##########
#....#...#
#.@..#.0.#
#....#...#
#....#...#
.#.##....#
.#.......#
.#.......#
..#1.....#
...######