..#####...#
..........#
....##....#
.#....###.#
@##.....#.#
...#..#.#.#
##.#..#...#
......###.#
.0.#..#...#
..#.#.#..1#
###########