#######
#......###
#.@#.#...#
#.##.###.#
#...0....#
#.##.###.#
#..#.#1..#
.#.#.#....#
.#........#
.######...#
##########