#..#...#@.#
#....0.#1.#
#...#.##.#
.#...#....#
...#...#..#
.....##..#
...##.....#
..#.......#
......#.#.#
#....#....#
##########